1;1
1;1
10
WW WW WW WW WW WW WW WW WW WW WW WW WW WW WW WW WW
WW SP C1 CG CG CG CG CG CG CG WW CV CV CV CV SG WW
WW WW WW WW WW WW WW WW WW WW WW WW WW WW WW WW WW
-----
10;11
7;8
10
WW WW WW WW WW WW WW WW WW WW WW WW WW WW WW WW WW
WW C1 CG CG CG CG CG CG CG CG CG CG CG CG CG C1 WW
WW CG WW WW WW CG WW WW WW WW WW CG WW WW WW CG WW
WW CG CG CG CG CG CG WW WW WW CG CG CG CG CG CG WW
WW CG WW WW WW WW CV CV CV CV CV WW WW WW WW CG WW
WW CG CG CG WW CV CV CV SG CV CV CV WW CG CG CG WW
WW WW WW CG WW CV WW WW GD WW WW CV WW CG WW WW WW
WW WW WW CG WW CV WW SG SG SG WW CV WW CG WW WW WW 
WW WW WW CG CV CV WW WW WW WW WW CV CV CG WW WW WW
WW WW WW CG WW CV CV CV C1 CV CV CV WW CG WW WW WW
WW WW WW CG WW CG WW WW WW WW WW CG WW CG WW WW WW 
WW CG CG CG CG CG CG CG CG CG SP CG CG CG CG CG WW 
WW CG WW WW WW CG WW WW WW WW WW CG WW WW WW CG WW 
WW CG WW WW WW CG CV CV SP CV CV CG WW WW WW CG WW 
WW CG WW WW WW CG WW WW CV WW WW CG WW WW WW CG WW 
WW C1 CG CG CG CG CG CG CG CG CG CG CG CG CG C1 WW 
WW WW WW WW WW WW WW WW WW WW WW WW WW WW WW WW WW
-----
10;17
10;8
5
WW WW WW WW WW WW WW WW WW WW WW WW WW WW WW WW WW WW WW WW WW
WW C3 CG CG CG CG CG CG CG CG CG CG CG CG CG CG CG CG CG C3 WW  
WW CG WW WW CG WW WW WW WW WW CV WW WW WW WW WW CG WW WW CG WW
WW CG WW CG CG CG CG CG CG CV C3 CV CG CG CG CG CG CG CG CG WW
WW CG WW CG WW WW WW CG WW WW WW WW WW CG WW WW WW WW WW CG WW
WW CG WW CG WW WW WW CG WW WW WW WW WW CG WW WW WW WW WW CG WW
WW CG WW CG CG CG WW CG CV CV SG CV CV CG WW CG CG CG WW CG WW
WW CG CG CG WW CG WW CG WW WW GD WW WW CG WW CG WW CG CG CG WW
WW CG WW CG WW C3 CG CG WW SG SG SG WW CG CG C3 WW CG WW CG WW
WW CG WW CG WW WW WW CG WW WW WW WW WW CG WW WW WW CG WW CG WW
WW CG CG CG CG CG CG CG CG CG C3 CG CG CG CG CG CG CG CG CG WW
WW CG WW CG WW WW WW WW WW WW CG WW WW WW WW WW WW WW WW CG WW
WW CG WW CG CG CG CG CG CG CG CG CG CG CG CG CG CG CG WW CG WW
WW CG WW CG WW CG CG WW WW WW CG WW WW WW CG CG WW CG WW CG WW
WW CG WW CG WW WW C3 CG WW WW CG WW WW CG C3 WW WW CG WW CG WW
WW CG CG CG WW WW WW CG WW WW CG WW WW CG WW WW WW CG CG CG WW
WW CG WW CG WW WW WW CG WW WW CV WW WW CG WW WW WW CG WW CG WW
WW CG WW CG CG CG CG CG CG CV SP CV CG CG CG CG CG CG WW CG WW
WW CG WW WW WW CG WW WW WW WW CG WW WW WW WW CG WW WW WW CG WW
WW C3 CG CG CG CG CG CG CG CG CV CG CG CG CG CG CG CG CG C3 WW
WW WW WW WW WW WW WW WW WW WW WW WW WW WW WW WW WW WW WW WW WW
-----
10;11
8;7
10
WW WW WW WW WW WW WW WW WW WW WW WW WW WW WW WW WW
WW CG CG CG CG CG CG CG CG CG CG CG CG CG CG CG WW
WW CG WW WW WW CG WW WW WW WW WW CG WW WW WW CG WW
WW CG CG CG CG CG CG WW WW WW CG CG CG CG CG CG WW
WW CG WW WW WW WW CV CV CV CV CV WW WW WW WW CG WW
WW CG CG CG WW CV CV CV SG CV CV CV WW CG CG CG WW
WW WW WW CG WW CV WW WW GD WW WW CV WW CG WW WW WW
WW WW WW CG WW CV WW SG SG SG WW CV WW CG WW WW WW 
WW WW WW CG CV CV WW WW WW WW WW CV CV CG WW WW WW
WW WW WW CG WW CV CV CV C1 CV CV CV WW CG WW WW WW
WW WW WW CG WW CG WW WW WW WW WW CG WW CG WW WW WW 
WW CG CG CG CG CG CG CG CG CG SP CG CG CG CG CG WW 
WW CG WW WW WW CG WW WW WW WW WW CG WW WW WW CG WW 
WW CG WW WW WW CG CV CV SP CV CV CG WW WW WW CG WW 
WW CG WW WW WW CG WW WW CV WW WW CG WW WW WW CG WW 
WW CG CG CG CG CG CG CG CG CG CG CG CG CG CG CG WW 
WW WW WW WW WW WW WW WW WW WW WW WW WW WW WW WW WW